222222222222
200000000002
200000000002
200000000002
200000000002
200000000002
200000000002
222222222222
000000000000
020000000020
000000000000
000001000000
000000000000
000000000000
020000000020
000000000000