222222222222
222200022222
222000000222
200000000002
200000000002
222000002222
222220022222
222222222222