222222222222
200000000002
200220022002
200000000002
200000000002
200220022002
200000000002
222222222222
222222222222
000000000000
030000000030
000000000000
000000000000
000000000000
000000000000
030000000030
000000000000