222222222222
200000000002
200220022002
200000000002
200000000002
200220022002
200000000002
222222222222