222222222222
222220022222
222220022222
200000000002
200000000002
222220022222
222220022222
222222222222
222222222222
000000000000
000000000000
000000000000
001000000000
000000000010
000000000000
000000000000
000000000000