222222222222
222220022222
22222002222
200000000002
200000000002
222220022222
222220022222
222222222222