222222222222
220000000022
200000000002
200000000002
200000000002
200000000002
220000000022
222222222222