222222222222
221100001122
200000000002
200000000002
200000000002
200000000002
221100001122
222222222222
111111111111