222222222222
221100001122
200000000002
200000000002
200000000002
200000000002
221100001122
222222222222
101010101010
020202020202
000300003000
000004400000