222222222222
210000000012
200222222002
200222222002
200222222002
200222222002
210000000012
222222222222
000000000000
020000000020
000000000000
000000000000
000000000000
000000000000
020000000020
000000000000