222222222222
200000000002
200222222002
200222222002
200222222002
200222222002
200000000002
222222222222