222222222222
200000000002
222220022222
200000000002
200000000002
211220022112
200110011002
222222222222