222222222222
220000000022
202000000202
200000000002
200000000002
202000000202
220000000022
222222222222
000000000000
003000000300
000000000000
000000000000
000000000000
000000000000
003000000300
000000000000