222222222222
200000000002
200000000002
200777777002
200777777002
200000000002
200000000002
222222222222