222222222222
200000000002
200000000002
200777777002
200777777002
200000000002
200000000002
222222222222
000000000000
010000000020
000000000000
000000000000
000000000000
000000000000
040000000030
000000000000