222222222222
200000000002
200000000002
200000000002
200000000002
200000000002
200000000002
222222222222
000000000000
000000000000
000000000000
000000600000
000000000000
000000000000
000000000000
000000000000