222222222222
200000000002
200000000002
200000000002
200000000002
200000000002
200000000002
222222222222
000000000000
000000000000
000000000000
000005000000
000000000000
000000000000
000000000000
000000000000